{
    "tile": "tiles/tile5.png",
    "tileRow": 13,
    "map": [
        [7, 12, 12, 12, 12, 12, 12, 12, 12, 12, 12, 12, 12, 12, 8],
        [11, 0, 0, 0, 0, 0, 1, 1, 1, 1, 1, 1, 1, 1, 3],
        [11, 0, 1, 1, 1, 1, 1, 1, 1, 1, 1, 1, 0, 0, 3],
        [11, 1, 2, 1, 1, 1, 1, 1, 1, 1, 0, 0, 0, 1, 3],
        [11, 1, 2, 1, 1, 1, 1, 1, 1, 1, 1, 1, 1, 1, 3],
        [11, 0, 2, 0, 1, 1, 1, 1, 1, 1, 1, 1, 1, 1, 3],
        [11, 0, 0, 0, 1, 1, 1, 1, 1, 1, 1, 1, 0, 0, 3],
        [9, 4, 4, 4, 4, 4, 4, 4, 4, 4, 4, 4, 4, 4, 10]
    ]
}