{
    "tile": "tiles/tile5.png",
    "tileRow": 7,
    "map": [
        [2, 3, 8, 9, 2, 3, 8, 9, 2, 3, 8, 9, 2, 3, 8, 9, 2, 3, 8, 9, 2, 3, 8, 9],
        [7, 0, 0, 1, 1, 0, 1, 1, 1, 1, 1, 1, 1, 1, 1, 1, 1, 0, 1, 1, 0, 0, 0, 7],
        [4, 0, 1, 1, 7, 7, 1, 1, 0, 1, 7, 2, 3, 7, 0, 1, 1, 1, 2, 3, 1, 1, 0, 4],
        [7, 0, 1, 1, 4, 4, 0, 1, 1, 1, 4, 2, 3, 4, 0, 1, 1, 0, 8, 9, 1, 1, 1, 7],
        [4, 1, 1, 0, 1, 1, 1, 1, 1, 1, 8, 9, 8, 9, 1, 1, 1, 1, 1, 1, 1, 1, 1, 4],
        [7, 1, 1, 1, 7, 7, 1, 1, 1, 1, 1, 1, 1, 1, 1, 1, 0, 1, 7, 7, 0, 1, 1, 7],
        [4, 0, 2, 3, 4, 4, 2, 3, 1, 1, 0, 1, 1, 1, 1, 1, 8, 9, 4, 4, 2, 3, 0, 4],
        [7, 1, 8, 9, 10, 10, 2, 3, 1, 1, 1, 10, 10, 0, 1, 1, 2, 3, 10, 10, 8, 9, 1, 7],
        [4, 1, 8, 9, 7, 7, 8, 9, 1, 0, 1, 1, 1, 1, 1, 1, 2, 3, 7, 7, 8, 9, 1, 4],
        [7, 1, 1, 0, 4, 4, 1, 1, 1, 1, 1, 1, 0, 1, 1, 1, 1, 1, 4, 4, 0, 1, 1, 7],
        [4, 0, 1, 1, 0, 1, 1, 0, 1, 1, 8, 9, 8, 9, 1, 1, 0, 1, 1, 1, 1, 1, 1, 4],
        [7, 1, 1, 1, 2, 3, 1, 1, 1, 1, 7, 2, 3, 7, 1, 1, 1, 1, 7, 7, 1, 1, 0, 7],
        [4, 0, 1, 1, 8, 9, 1, 1, 0, 1, 4, 2, 3, 4, 0, 1, 1, 1, 4, 4, 1, 1, 0, 4],
        [10, 0, 0, 0, 1, 0, 1, 1, 1, 0, 1, 1, 1, 1, 1, 1, 1, 0, 1, 1, 1, 0, 0, 10],
        [2, 3, 8, 9, 2, 3, 8, 9, 2, 3, 8, 9, 2, 3, 8, 9, 2, 3, 8, 9, 2, 3, 8, 9]
    ]
}
