{
    "tile": "tiles/tile5.png",
    "tileRow": 7,
    "map": [
        [2, 3, 8, 9, 2, 3, 8, 9, 2, 3, 8, 9, 2, 3, 8, 9, 2, 3, 8, 9, 2, 3, 8, 9],
        [7, 0, 0, 1, 1, 0, 1, 1, 1, 1, 0, 8, 9, 1, 1, 1, 1, 0, 1, 1, 0, 0, 0, 7],
        [4, 0, 7, 8, 9, 1, 1, 1, 0, 1, 1, 2, 3, 1, 0, 1, 1, 1, 1, 8, 9, 7, 0, 4],
        [7, 0, 4, 10, 7, 7, 8, 9, 1, 1, 1, 1, 1, 1, 0, 1, 8, 9, 7, 7, 10, 4, 1, 7],
        [4, 1, 2, 3, 4, 4, 10, 7, 7, 8, 9, 1, 0, 8, 9, 7, 7, 10, 4, 4, 2, 3, 1, 4],
        [7, 1, 1, 1, 1, 2, 3, 4, 4, 10, 7, 1, 1, 7, 10, 4, 4, 2, 3, 1, 0, 1, 1, 7],
        [4, 0, 1, 1, 1, 1, 0, 1, 2, 3, 4, 1, 1, 4, 2, 3, 1, 1, 1, 1, 1, 1, 0, 4],
        [7, 1, 1, 0, 1, 1, 1, 1, 0, 1, 1, 0, 0, 1, 1, 1, 1, 1, 0, 1, 0, 1, 1, 7],
        [4, 1, 0, 1, 1, 1, 1, 1, 2, 3, 7, 1, 1, 7, 2, 3, 1, 1, 1, 1, 1, 1, 1, 4],
        [7, 1, 1, 1, 0, 2, 3, 7, 7, 10, 4, 1, 0, 4, 10, 7, 7, 2, 3, 1, 0, 1, 1, 7],
        [4, 0, 2, 3, 7, 7, 10, 4, 4, 8, 9, 1, 1, 8, 9, 4, 4, 10, 7, 7, 2, 3, 1, 4],
        [7, 1, 7, 10, 4, 4, 8, 9, 1, 1, 1, 1, 1, 1, 1, 1, 8, 9, 4, 4, 10, 7, 0, 7],
        [4, 0, 4, 8, 9, 1, 1, 1, 0, 1, 1, 2, 3, 1, 0, 1, 1, 1, 1, 8, 9, 4, 0, 4],
        [10, 0, 0, 0, 1, 0, 1, 1, 1, 0, 1, 8, 9, 1, 1, 1, 1, 0, 1, 1, 1, 0, 0, 10],
        [2, 3, 8, 9, 2, 3, 8, 9, 2, 3, 8, 9, 2, 3, 8, 9, 2, 3, 8, 9, 2, 3, 8, 9]
    ]
}
